1000000000001 
1000000000001
1000000000001 
1000000000001 
1000000000001 
1000000000001 
1000000000001 
1000000000001 
1011001100001 
1111111111111 
{ "image_path": "C:\\Users\\Jake\\Documents\\GitHub\\2dPlatformerEngine\\2dPlatformerEngine\\Maps\\Tilemaps\\tilemap_test.png" }