1111111111111111111111111
1000000000000000000000001
1000000000000000000000001
1000000000000000000000001
1000000000000000000000001
1000000000000000000000001
1000000000000000000000001
1000000000000000000000001
1000000000000000000000001
1000000000000000000000001
1000000000000000000000001
1000000000000000000001111
1000000000000000000010001
1000000000000000110000001
1000000000001100001000001
1000000011100000000010001
1000001000000000000000011
1000111000000000000000111
1001111000000000000001111
1111111111111111111111111
{ "image_path": "C:\\Users\\Jake\\Documents\\GitHub\\2dPlatformerEngine\\2dPlatformerEngine\\Maps\\Tilemaps\\tilemap_test.png" }